511,511-20160704-07-000372.txt,2,0,1,3
511,511-20160502-18-000094.txt,2,0,0,2
511,511-20160704-18-000259.txt,6,0,0,6
511,511-20160508-15-000006.txt,5,0,0,5
511,511-20160704-12-000229.txt,2,0,0,2
511,511-20160508-18-000141.txt,2,0,0,2
511,511-20160429-12-000054.txt,18,0,2,20
511,511-20160704-15-000035.txt,2,0,1,3
511,511-20160704-07-000326.txt,3,0,1,4
511,511-20160502-18-000017.txt,5,1,0,6
511,511-20160508-15-000297.txt,3,0,0,3
511,511-20160704-15-000004.txt,2,1,1,4
511,511-20160704-12-000115.txt,5,0,0,5
511,511-20160704-07-000429.txt,0,0,1,1
511,511-20160430-15-000032.txt,22,1,0,23
511,511-20160704-07-000173.txt,1,0,1,2
511,511-20160508-15-000226.txt,5,0,0,5
511,511-20160704-12-000225.txt,3,0,0,3
511,511-20160429-12-000107.txt,21,0,2,23
511,511-20160429-12-000123.txt,20,0,2,22
511,511-20160505-18-000066.txt,2,0,0,2
511,511-20160508-18-000219.txt,2,0,0,2
511,511-20160505-18-000212.txt,4,0,0,4
511,511-20160504-18-000221.txt,4,0,0,4
511,511-20160505-18-000213.txt,3,0,0,3
511,511-20160704-15-000021.txt,3,0,1,4
511,511-20160429-18-000071.txt,5,1,0,6
511,511-20160503-07-000149.txt,1,0,0,1
511,511-20160429-15-000293.txt,3,0,1,4
511,511-20160704-07-000167.txt,1,0,1,2
511,511-20160502-18-000071.txt,2,0,0,2
511,511-20160429-07-000208.txt,4,0,0,4
511,511-20160704-12-000276.txt,6,0,0,6
511,511-20160505-18-000134.txt,5,0,0,5
511,511-20160430-15-000026.txt,25,0,0,25
511,511-20160505-18-000092.txt,2,0,0,2
511,511-20160508-18-000008.txt,4,0,0,4
511,511-20160430-15-000040.txt,24,0,0,24
511,511-20160429-07-000088.txt,5,1,0,6
511,511-20160503-07-000143.txt,1,1,0,2
511,511-20160504-18-000088.txt,2,0,1,3
511,511-20160429-15-000147.txt,3,1,1,5
511,511-20160508-15-000295.txt,4,0,0,4
511,511-20160429-18-000072.txt,5,1,0,6
511,511-20160429-12-000240.txt,16,1,3,20
511,511-20160704-07-000275.txt,0,0,1,1
511,511-20160502-18-000227.txt,3,0,0,3
511,511-20160505-18-000013.txt,2,0,0,2
511,511-20160505-18-000250.txt,3,0,0,3
511,511-20160504-18-000298.txt,4,0,0,4
511,511-20160704-12-000095.txt,4,1,0,5
511,511-20160430-15-000119.txt,23,0,0,23
511,511-20160704-12-000168.txt,5,1,0,6
511,511-20160508-15-000068.txt,3,1,0,4
511,511-20160508-18-000064.txt,2,0,0,2
511,511-20160505-18-000105.txt,5,0,0,5
511,511-20160704-12-000103.txt,4,0,0,4
511,511-20160505-18-000015.txt,2,0,0,2
511,511-20160704-07-000082.txt,3,0,1,4
511,511-20160502-18-000075.txt,2,0,0,2
511,511-20160508-18-000152.txt,2,0,0,2
511,511-20160429-15-000109.txt,3,1,2,6
511,511-20160704-12-000273.txt,4,0,0,4
511,511-20160505-18-000227.txt,3,0,0,3
511,511-20160704-18-000183.txt,6,0,0,6
511,511-20160704-07-000444.txt,0,0,1,1
511,511-20160429-15-000296.txt,3,0,1,4
511,511-20160704-07-000260.txt,0,0,1,1
511,511-20160704-12-000153.txt,3,1,0,4
511,511-20160505-18-000245.txt,3,0,0,3
511,511-20160704-15-000020.txt,4,0,1,5
511,511-20160429-12-000115.txt,18,0,2,20
511,511-20160704-07-000217.txt,1,0,1,2
511,511-20160704-15-000068.txt,5,0,1,6
511,511-20160704-07-000087.txt,3,0,1,4
511,511-20160430-15-000105.txt,24,0,0,24
511,511-20160429-15-000073.txt,4,0,1,5
511,511-20160502-18-000174.txt,2,0,1,3
511,511-20160508-18-000289.txt,5,0,0,5
511,511-20160502-18-000074.txt,4,0,0,4
511,511-20160508-15-000004.txt,4,0,0,4
511,511-20160704-07-000332.txt,1,0,1,2
511,511-20160704-07-000316.txt,4,0,1,5
511,511-20160502-18-000138.txt,6,0,0,6
511,511-20160429-18-000289.txt,4,1,0,5
511,511-20160704-12-000005.txt,4,0,0,4
511,511-20160430-15-000127.txt,20,0,1,21
511,511-20160505-18-000244.txt,3,0,0,3
511,511-20160505-18-000070.txt,2,0,0,2
511,511-20160704-07-000222.txt,1,0,1,2
511,511-20160704-07-000094.txt,1,1,1,3
511,511-20160504-18-000001.txt,2,1,0,3
511,511-20160704-07-000063.txt,0,0,1,1
511,511-20160503-07-000146.txt,1,1,0,2
511,511-20160704-15-000024.txt,3,0,1,4
511,511-20160502-18-000078.txt,1,0,0,1
511,511-20160704-07-000018.txt,1,0,1,2
511,511-20160502-18-000088.txt,1,0,0,1
511,511-20160508-15-000009.txt,4,0,0,4
511,511-20160502-18-000232.txt,5,0,0,5
511,511-20160429-12-000103.txt,23,0,2,25
511,511-20160505-18-000255.txt,3,0,0,3
511,511-20160502-18-000289.txt,4,0,0,4
511,511-20160508-15-000150.txt,4,0,0,4
511,511-20160508-18-000143.txt,2,0,0,2
511,511-20160704-07-000250.txt,1,0,1,2
511,511-20160504-18-000217.txt,2,0,0,2
511,511-20160429-12-000261.txt,20,0,3,23
511,511-20160704-07-000368.txt,1,0,1,2
511,511-20160429-07-000148.txt,6,0,0,6
511,511-20160704-07-000204.txt,1,0,1,2
511,511-20160429-15-000213.txt,4,1,1,6
511,511-20160502-18-000170.txt,4,0,1,5
511,511-20160704-07-000049.txt,0,0,1,1
511,511-20160504-18-000073.txt,2,0,0,2
511,511-20160429-07-000220.txt,3,0,0,3
511,511-20160430-15-000037.txt,21,0,0,21
511,511-20160704-07-000405.txt,0,0,2,2
511,511-20160502-18-000089.txt,1,0,0,1
511,511-20160505-18-000078.txt,2,0,0,2
511,511-20160430-15-000259.txt,23,0,0,23
511,511-20160429-18-000229.txt,4,1,0,5
511,511-20160429-18-000219.txt,4,1,0,5
511,511-20160502-18-000173.txt,2,0,1,3
511,511-20160502-18-000251.txt,6,0,0,6
511,511-20160504-18-000098.txt,2,0,1,3
511,511-20160704-07-000242.txt,5,0,1,6
511,511-20160503-07-000076.txt,3,0,2,5
511,511-20160704-12-000148.txt,3,1,0,4
511,511-20160429-07-000282.txt,3,1,0,4
511,511-20160704-12-000007.txt,3,0,0,3
511,511-20160704-12-000100.txt,4,0,0,4
511,511-20160503-07-000214.txt,4,0,1,5
511,511-20160504-18-000209.txt,5,0,0,5
511,511-20160429-12-000272.txt,25,0,1,26
511,511-20160704-07-000241.txt,5,0,1,6
511,511-20160503-18-000115.txt,19,2,0,21
511,511-20160430-15-000113.txt,21,0,0,21
511,511-20160704-07-000230.txt,2,0,1,3
511,511-20160704-07-000427.txt,0,0,1,1
511,511-20160504-18-000140.txt,6,0,0,6
511,511-20160503-07-000157.txt,4,0,0,4
511,511-20160430-15-000184.txt,23,0,0,23
511,511-20160502-18-000100.txt,4,0,0,4
511,511-20160429-12-000178.txt,19,0,2,21
511,511-20160430-15-000023.txt,22,0,0,22
511,511-20160704-07-000059.txt,1,0,1,2
511,511-20160704-07-000457.txt,0,0,1,1
511,511-20160430-15-000181.txt,24,0,0,24
511,511-20160508-18-000155.txt,4,0,0,4
511,511-20160429-12-000286.txt,24,1,0,25
511,511-20160429-07-000242.txt,6,0,0,6
511,511-20160704-15-000010.txt,2,0,1,3
511,511-20160704-15-000018.txt,3,0,1,4
511,511-20160429-07-000244.txt,6,0,0,6
511,511-20160704-07-000108.txt,0,1,1,2
511,511-20160429-07-000058.txt,4,0,0,4
511,511-20160503-07-000067.txt,3,0,2,5
511,511-20160704-07-000047.txt,0,0,1,1
511,511-20160508-15-000005.txt,4,0,0,4
511,511-20160704-07-000377.txt,2,0,1,3
511,511-20160704-12-000169.txt,3,1,0,4
511,511-20160429-07-000085.txt,5,0,0,5
511,511-20160505-18-000232.txt,3,0,0,3
511,511-20160704-15-000016.txt,2,0,1,3
511,511-20160508-18-000011.txt,6,0,0,6
511,511-20160429-18-000148.txt,5,1,0,6
511,511-20160505-18-000011.txt,2,0,0,2
511,511-20160704-07-000360.txt,1,0,1,2
511,511-20160504-18-000075.txt,1,1,0,2
511,511-20160704-07-000367.txt,1,0,1,2
511,511-20160704-07-000389.txt,5,0,1,6
511,511-20160429-12-000281.txt,29,1,1,31
511,511-20160704-07-000019.txt,1,0,2,3
511,511-20160704-12-000252.txt,3,0,0,3
511,511-20160504-18-000023.txt,4,1,0,5
511,511-20160704-07-000079.txt,1,0,1,2
511,511-20160704-12-000025.txt,4,0,0,4
511,511-20160429-07-000284.txt,3,1,0,4
511,511-20160505-18-000225.txt,3,0,0,3
511,511-20160430-15-000099.txt,23,0,0,23
511,511-20160505-18-000136.txt,2,0,0,2
511,511-20160508-15-000151.txt,5,0,0,5
511,511-20160503-07-000094.txt,4,0,2,6
511,511-20160502-18-000146.txt,2,0,0,2
511,511-20160429-15-000228.txt,3,2,1,6
511,511-20160429-12-000285.txt,25,1,0,26
511,511-20160429-07-000286.txt,3,1,0,4
511,511-20160508-18-000080.txt,5,0,0,5
511,511-20160505-18-000241.txt,3,0,0,3
511,511-20160429-12-000120.txt,20,0,1,21
511,511-20160430-15-000251.txt,21,0,0,21
511,511-20160704-07-000453.txt,0,0,1,1
511,511-20160503-18-000252.txt,23,0,0,23
511,511-20160429-12-000110.txt,19,0,2,21
511,511-20160704-12-000023.txt,4,0,0,4
511,511-20160508-18-000156.txt,4,0,0,4
511,511-20160429-18-000288.txt,4,1,0,5
511,511-20160504-18-000142.txt,6,0,0,6
511,511-20160502-18-000152.txt,1,0,0,1
495,495-20160704-07-000263.txt,12,0,0,12
495,495-20160430-18-000218.txt,7,0,2,9
495,495-20160430-15-000201.txt,0,0,0,0
495,495-20160508-15-000137.txt,6,0,0,6
495,495-20160508-18-000144.txt,9,0,0,9
495,495-20160430-15-000362.txt,0,0,0,0
495,495-20160508-18-000208.txt,6,0,0,6
495,495-20160429-15-000092.txt,6,1,1,8
495,495-20160430-18-000138.txt,9,0,1,10
495,495-20160704-07-000192.txt,10,0,1,11
495,495-20160429-07-000151.txt,6,0,3,9
495,495-20160429-15-000253.txt,9,0,2,11
495,495-20160503-07-000011.txt,10,0,1,11
495,495-20160429-15-000131.txt,9,0,0,9
495,495-20160429-15-000105.txt,4,1,1,6
495,495-20160508-15-000243.txt,10,0,0,10
495,495-20160502-18-000216.txt,9,1,1,11
495,495-20160430-15-000327.txt,0,0,0,0
495,495-20160503-18-000139.txt,9,0,0,9
495,495-20160429-18-000062.txt,9,0,0,9
495,495-20160429-18-000201.txt,10,0,1,11
495,495-20160430-15-000321.txt,0,0,0,0
495,495-20160430-18-000055.txt,10,0,1,11
495,495-20160503-07-000021.txt,10,0,1,11
495,495-20160503-07-000004.txt,11,0,1,12
495,495-20160429-07-000229.txt,6,0,2,8
495,495-20160505-18-000067.txt,6,0,1,7
495,495-20160502-18-000212.txt,9,1,1,11
495,495-20160430-18-000072.txt,9,0,1,10
495,495-20160430-15-000190.txt,0,0,0,0
495,495-20160429-12-000025.txt,20,0,3,23
495,495-20160429-15-000211.txt,5,1,0,6
495,495-20160704-07-000079.txt,12,0,0,12
495,495-20160429-18-000220.txt,10,0,0,10
495,495-20160503-07-000262.txt,8,0,2,10
495,495-20160430-15-000543.txt,7,0,2,9
495,495-20160503-07-000235.txt,9,0,2,11
495,495-20160430-15-000202.txt,0,0,0,0
495,495-20160504-18-000276.txt,11,0,0,11
495,495-20160429-15-000220.txt,9,0,0,9
495,495-20160429-15-000095.txt,6,1,1,8
495,495-20160503-18-000246.txt,11,0,0,11
495,495-20160430-15-000023.txt,7,1,2,10
495,495-20160503-18-000142.txt,11,0,0,11
495,495-20160503-07-000255.txt,9,0,2,11
495,495-20160503-07-000054.txt,8,0,1,9
495,495-20160503-18-000056.txt,6,1,0,7
495,495-20160429-18-000056.txt,5,1,0,6
495,495-20160503-18-000129.txt,11,0,0,11
495,495-20160704-07-000068.txt,12,0,0,12
495,495-20160430-15-000016.txt,0,0,0,0
495,495-20160508-15-000232.txt,9,0,0,9
495,495-20160430-15-000018.txt,0,0,0,0
495,495-20160429-18-000047.txt,11,0,1,12
495,495-20160508-18-000063.txt,12,0,0,12
495,495-20160704-07-000098.txt,12,0,0,12
495,495-20160508-18-000247.txt,9,0,0,9
495,495-20160504-18-000256.txt,9,1,1,11
495,495-20160503-07-000129.txt,6,0,2,8
495,495-20160429-15-000198.txt,9,0,0,9
495,495-20160704-12-000142.txt,11,1,0,12
495,495-20160704-07-000176.txt,12,0,0,12
495,495-20160502-18-000167.txt,9,1,1,11
495,495-20160508-15-000120.txt,8,0,0,8
495,495-20160508-18-000278.txt,11,0,0,11
495,495-20160429-07-000230.txt,6,0,2,8
495,495-20160503-07-000022.txt,10,0,1,11
495,495-20160429-07-000217.txt,7,1,2,10
495,495-20160508-15-000065.txt,10,0,0,10
495,495-20160430-15-000318.txt,0,0,0,0
495,495-20160704-07-000032.txt,10,0,1,11
495,495-20160704-15-000124.txt,24,0,0,24
495,495-20160508-18-000103.txt,23,0,0,23
495,495-20160503-18-000239.txt,11,0,0,11
495,495-20160429-15-000230.txt,8,0,1,9
495,495-20160704-07-000236.txt,10,1,0,11
495,495-20160503-18-000038.txt,12,0,0,12
495,495-20160504-18-000252.txt,9,0,1,10
495,495-20160503-07-000267.txt,9,0,2,11
495,495-20160503-07-000229.txt,7,0,1,8
495,495-20160429-07-000276.txt,8,0,3,11
495,495-20160430-15-000111.txt,10,0,1,11
495,495-20160429-07-000004.txt,10,0,1,11
495,495-20160508-15-000130.txt,9,0,0,9
495,495-20160430-15-000304.txt,0,0,0,0
495,495-20160430-15-000122.txt,8,0,2,10
495,495-20160503-18-000120.txt,11,0,0,11
495,495-20160502-18-000052.txt,9,1,1,11
495,495-20160502-18-000156.txt,9,1,1,11
495,495-20160430-15-000313.txt,0,0,0,0
495,495-20160502-18-000227.txt,9,0,1,10
495,495-20160429-07-000144.txt,7,0,2,9
495,495-20160503-18-000210.txt,6,0,0,6
495,495-20160704-07-000234.txt,10,1,0,11
495,495-20160508-15-000073.txt,10,0,1,11
495,495-20160430-15-000417.txt,0,0,0,0
495,495-20160503-07-000002.txt,10,0,1,11
495,495-20160430-15-000196.txt,0,0,0,0
495,495-20160505-18-000077.txt,8,0,1,9
495,495-20160504-18-000203.txt,8,0,1,9
495,495-20160429-07-000133.txt,8,0,3,11
495,495-20160429-12-000103.txt,20,0,2,22
495,495-20160505-18-000209.txt,10,0,1,11
495,495-20160704-15-000139.txt,22,0,0,22
495,495-20160429-15-000084.txt,7,1,1,9
495,495-20160429-15-000042.txt,10,0,0,10
495,495-20160429-15-000189.txt,9,1,1,11
495,495-20160503-07-000192.txt,7,0,3,10
495,495-20160504-18-000261.txt,9,0,1,10
495,495-20160508-15-000040.txt,7,1,0,8
495,495-20160429-07-000061.txt,10,1,1,12
495,495-20160429-07-000147.txt,7,0,2,9
495,495-20160704-15-000266.txt,22,0,0,22
495,495-20160508-15-000066.txt,9,0,0,9
495,495-20160508-15-000292.txt,9,0,0,9
495,495-20160430-15-000386.txt,0,0,0,0
495,495-20160704-15-000137.txt,23,0,0,23
495,495-20160429-07-000270.txt,9,0,2,11
495,495-20160430-15-000013.txt,0,0,0,0
495,495-20160429-18-000059.txt,7,1,0,8
495,495-20160505-18-000176.txt,9,1,1,11
495,495-20160508-18-000209.txt,6,0,0,6
495,495-20160505-18-000216.txt,10,0,2,12
495,495-20160503-18-000138.txt,10,0,1,11
495,495-20160503-07-000047.txt,8,0,2,10
495,495-20160704-18-000260.txt,11,0,0,11
495,495-20160503-18-000049.txt,7,1,0,8
495,495-20160503-18-000267.txt,11,0,1,12
495,495-20160502-18-000294.txt,8,0,2,10
495,495-20160704-07-000233.txt,10,1,0,11
495,495-20160430-15-000255.txt,0,0,0,0
495,495-20160503-18-000132.txt,10,0,1,11
495,495-20160430-15-000267.txt,0,0,0,0
495,495-20160704-12-000063.txt,11,0,1,12
495,495-20160429-15-000130.txt,11,0,0,11
495,495-20160505-18-000222.txt,7,0,2,9
495,495-20160508-18-000150.txt,10,0,1,11
495,495-20160429-15-000298.txt,4,0,2,6
495,495-20160430-15-000032.txt,6,2,2,10
495,495-20160429-15-000263.txt,9,0,2,11
495,495-20160508-18-000280.txt,11,0,0,11
495,495-20160429-15-000194.txt,10,0,0,10
495,495-20160508-15-000299.txt,11,0,0,11
495,495-20160508-15-000208.txt,10,0,0,10
495,495-20160429-15-000225.txt,7,0,1,8
495,495-20160429-15-000066.txt,5,1,1,7
495,495-20160429-18-000041.txt,10,0,1,11
495,495-20160508-15-000230.txt,9,0,0,9
495,495-20160504-18-000148.txt,9,0,0,9
495,495-20160429-07-000227.txt,6,1,2,9
495,495-20160503-07-000149.txt,8,0,1,9
495,495-20160508-15-000039.txt,9,1,0,10
495,495-20160508-18-000246.txt,8,0,0,8
495,495-20160429-15-000193.txt,9,0,0,9
495,495-20160508-15-000054.txt,9,0,0,9
495,495-20160704-12-000064.txt,11,0,1,12
495,495-20160503-07-000221.txt,6,0,2,8
495,495-20160429-18-000071.txt,12,0,0,12
495,495-20160505-18-000081.txt,8,1,1,10
495,495-20160502-18-000158.txt,9,1,1,11
495,495-20160503-18-000047.txt,7,1,0,8
495,495-20160429-07-000150.txt,6,0,3,9
495,495-20160508-18-000220.txt,7,1,0,8
495,495-20160508-15-000129.txt,8,0,0,8
495,495-20160503-18-000206.txt,9,0,0,9
495,495-20160503-07-000062.txt,9,0,1,10
495,495-20160508-15-000048.txt,9,0,0,9
495,495-20160508-18-000145.txt,9,0,0,9
495,495-20160508-15-000223.txt,8,0,0,8
495,495-20160429-15-000065.txt,5,1,1,7
495,495-20160503-18-000135.txt,8,0,1,9
495,495-20160429-07-000126.txt,8,0,3,11
495,495-20160504-18-000064.txt,10,0,0,10
495,495-20160429-18-000196.txt,8,2,1,11
495,495-20160508-18-000068.txt,11,0,0,11
495,495-20160430-15-000128.txt,6,0,1,7
495,495-20160429-15-000125.txt,8,0,1,9
495,495-20160430-15-000026.txt,6,1,2,9
495,495-20160429-07-000267.txt,9,0,2,11
495,495-20160429-15-000282.txt,11,0,0,11
495,495-20160504-18-000132.txt,10,0,0,10
495,495-20160430-15-000377.txt,0,0,0,0
495,495-20160430-18-000296.txt,6,1,1,8
495,495-20160429-07-000233.txt,6,0,2,8
495,495-20160429-12-000276.txt,9,1,1,11
495,495-20160430-15-000265.txt,0,0,0,0
495,495-20160430-15-000262.txt,0,0,0,0
495,495-20160704-07-000127.txt,12,0,0,12
495,495-20160704-15-000114.txt,24,0,0,24
495,495-20160508-18-000138.txt,7,0,0,7
495,495-20160430-15-000463.txt,9,0,1,10
495,495-20160429-18-000143.txt,10,0,0,10
495,495-20160502-18-000166.txt,9,1,1,11
495,495-20160429-12-000034.txt,22,0,1,23
495,495-20160429-15-000294.txt,7,1,1,9
495,495-20160508-15-000238.txt,10,0,0,10
495,495-20160429-15-000259.txt,9,1,2,12
495,495-20160429-15-000076.txt,7,1,1,9
495,495-20160430-15-000289.txt,0,0,0,0
495,495-20160503-07-000200.txt,7,0,3,10
170,170-20160503-07-000276.txt,0,1,1,2
170,170-20160430-15-000044.txt,2,0,0,2
170,170-20160430-15-000078.txt,2,0,0,2
170,170-20160508-15-000077.txt,2,0,0,2
170,170-20160502-18-000008.txt,0,3,0,3
170,170-20160508-18-000038.txt,1,0,1,2
170,170-20160430-16-000094.txt,14,0,0,14
170,170-20160704-07-000210.txt,0,1,0,1
170,170-20160704-07-000202.txt,0,1,0,1
170,170-20160508-15-000090.txt,2,0,0,2
170,170-20160503-18-000001.txt,0,2,0,2
170,170-20160508-15-000013.txt,1,0,0,1
170,170-20160430-18-000063.txt,2,0,0,2
170,170-20160429-12-000296.txt,1,2,0,3
170,170-20160704-07-000069.txt,0,1,0,1
170,170-20160704-15-000257.txt,1,1,0,2
170,170-20160503-18-000285.txt,1,2,0,3
170,170-20160505-18-000128.txt,3,0,0,3
170,170-20160508-15-000290.txt,2,0,0,2
170,170-20160704-15-000101.txt,0,1,1,2
170,170-20160508-18-000164.txt,0,1,1,2
170,170-20160430-16-000188.txt,1,0,0,1
170,170-20160503-07-000047.txt,1,2,0,3
170,170-20160504-18-000159.txt,1,2,0,3
170,170-20160508-15-000081.txt,2,0,0,2
170,170-20160425-18-000044.txt,14,2,0,16
170,170-20160704-07-000242.txt,0,1,0,1
170,170-20160704-07-000040.txt,0,1,0,1
170,170-20160429-07-000087.txt,15,1,0,16
170,170-20160430-16-000186.txt,1,0,0,1
170,170-20160704-15-000165.txt,0,0,0,0
170,170-20160425-18-000186.txt,11,2,2,15
170,170-20160704-12-000162.txt,3,0,0,3
170,170-20160503-18-000299.txt,1,2,0,3
170,170-20160508-15-000001.txt,2,0,0,2
170,170-20160429-12-000292.txt,1,2,0,3
170,170-20160704-18-000256.txt,1,1,0,2
170,170-20160704-15-000163.txt,0,0,0,0
170,170-20160704-15-000100.txt,0,1,1,2
170,170-20160704-18-000268.txt,1,2,0,3
170,170-20160502-18-000251.txt,0,1,1,2
170,170-20160503-07-000054.txt,0,1,0,1
170,170-20160503-07-000053.txt,1,1,0,2
170,170-20160508-15-000215.txt,1,0,0,1
170,170-20160505-18-000002.txt,0,2,0,2
170,170-20160508-18-000220.txt,1,0,1,2
170,170-20160429-07-000055.txt,1,2,0,3
170,170-20160508-15-000285.txt,3,0,0,3
170,170-20160430-18-000066.txt,2,0,0,2
170,170-20160503-07-000130.txt,1,1,0,2
170,170-20160508-15-000002.txt,1,0,0,1
170,170-20160430-15-000070.txt,2,0,0,2
170,170-20160429-15-000117.txt,15,1,0,16
170,170-20160502-18-000178.txt,1,2,0,3
170,170-20160704-12-000160.txt,2,0,0,2
170,170-20160508-18-000070.txt,1,0,1,2
170,170-20160429-07-000168.txt,12,2,0,14
170,170-20160430-15-000048.txt,2,0,0,2
170,170-20160704-18-000279.txt,0,2,0,2
170,170-20160503-07-000290.txt,2,1,0,3
170,170-20160508-15-000168.txt,2,0,0,2
170,170-20160430-18-000046.txt,2,0,0,2
170,170-20160508-15-000249.txt,1,0,0,1
170,170-20160505-18-000256.txt,1,2,0,3
170,170-20160704-07-000112.txt,0,1,0,1
170,170-20160503-07-000120.txt,1,0,1,2
170,170-20160508-15-000135.txt,3,0,0,3
170,170-20160704-07-000147.txt,0,1,0,1
170,170-20160704-15-000186.txt,0,0,0,0
170,170-20160704-15-000015.txt,2,1,0,3
170,170-20160508-15-000292.txt,3,0,0,3
170,170-20160430-16-000176.txt,1,0,0,1
170,170-20160508-18-000093.txt,1,0,1,2
170,170-20160508-18-000089.txt,0,0,1,1
170,170-20160430-18-000188.txt,14,1,0,15
170,170-20160508-15-000138.txt,3,0,0,3
170,170-20160704-07-000271.txt,0,1,0,1
170,170-20160508-18-000064.txt,2,0,1,3
170,170-20160430-18-000068.txt,2,0,0,2
170,170-20160503-07-000121.txt,2,0,0,2
170,170-20160704-07-000215.txt,1,1,0,2
170,170-20160430-18-000048.txt,2,0,0,2
170,170-20160503-07-000214.txt,1,1,0,2
170,170-20160430-15-000074.txt,2,0,0,2
170,170-20160425-18-000049.txt,14,2,0,16
170,170-20160425-18-000202.txt,15,0,2,17
170,170-20160508-15-000219.txt,2,0,0,2
170,170-20160704-18-000179.txt,0,1,0,1
170,170-20160704-07-000141.txt,0,1,0,1
170,170-20160508-18-000217.txt,1,0,1,2
170,170-20160429-07-000156.txt,14,1,0,15
170,170-20160425-18-000189.txt,11,1,4,16
170,170-20160704-15-000247.txt,2,1,0,3
170,170-20160508-18-000056.txt,1,0,1,2
170,170-20160704-07-000055.txt,0,1,0,1
170,170-20160704-07-000050.txt,0,1,0,1
170,170-20160704-15-000235.txt,2,1,0,3
170,170-20160704-18-000249.txt,1,1,0,2
170,170-20160429-15-000195.txt,13,0,1,14
170,170-20160429-07-000045.txt,1,1,0,2
170,170-20160508-15-000234.txt,2,0,0,2
170,170-20160704-18-000190.txt,0,1,0,1
170,170-20160704-07-000060.txt,0,1,0,1
170,170-20160429-12-000082.txt,2,1,0,3
170,170-20160430-15-000142.txt,0,1,0,1
170,170-20160704-07-000247.txt,0,1,0,1
170,170-20160429-07-000047.txt,1,1,0,2
170,170-20160429-18-000101.txt,15,0,0,15
170,170-20160508-18-000053.txt,1,0,1,2
170,170-20160430-18-000187.txt,15,1,0,16
170,170-20160704-18-000275.txt,0,2,0,2
170,170-20160704-07-000044.txt,1,1,0,2
170,170-20160505-18-000073.txt,0,2,1,3
170,170-20160430-15-000072.txt,2,0,0,2
170,170-20160503-07-000040.txt,1,2,0,3
170,170-20160508-15-000011.txt,2,0,0,2
170,170-20160425-18-000276.txt,18,0,0,18
170,170-20160704-07-000104.txt,0,1,0,1
170,170-20160508-18-000063.txt,2,0,1,3
170,170-20160508-18-000219.txt,1,0,1,2
170,170-20160508-15-000066.txt,2,0,0,2
170,170-20160508-15-000007.txt,1,0,0,1
170,170-20160429-07-000095.txt,13,1,1,15
170,170-20160429-15-000038.txt,16,0,0,16
170,170-20160425-18-000117.txt,14,1,0,15
170,170-20160704-07-000201.txt,0,1,0,1
170,170-20160503-07-000273.txt,1,1,1,3
170,170-20160704-07-000135.txt,0,1,0,1
170,170-20160430-16-000193.txt,1,0,0,1
170,170-20160503-18-000169.txt,0,2,0,2
170,170-20160505-18-000074.txt,0,2,0,2
170,170-20160704-07-000140.txt,0,1,0,1
170,170-20160505-18-000254.txt,1,2,0,3
170,170-20160429-12-000295.txt,1,2,0,3
170,170-20160704-15-000105.txt,0,1,0,1
170,170-20160503-18-000152.txt,0,2,1,3
170,170-20160704-18-000088.txt,2,1,0,3
170,170-20160430-15-000076.txt,2,0,0,2
170,170-20160704-15-000112.txt,0,1,0,1
170,170-20160704-12-000176.txt,2,1,0,3
170,170-20160429-18-000102.txt,17,0,0,17
170,170-20160505-18-000132.txt,1,1,0,2
170,170-20160505-18-000260.txt,1,2,0,3
170,170-20160503-07-000114.txt,1,0,1,2
170,170-20160704-15-000166.txt,0,0,0,0
170,170-20160429-15-000122.txt,13,1,1,15
170,170-20160704-07-000128.txt,0,1,0,1
170,170-20160704-15-000237.txt,2,1,0,3
170,170-20160704-15-000097.txt,0,1,0,1
170,170-20160704-07-000207.txt,0,1,0,1
170,170-20160508-15-000241.txt,3,0,0,3
170,170-20160704-18-000274.txt,0,2,0,2
170,170-20160505-18-000131.txt,2,1,0,3
170,170-20160425-18-000196.txt,16,0,3,19
170,170-20160508-18-000087.txt,0,0,1,1
170,170-20160425-18-000284.txt,15,0,0,15
170,170-20160508-15-000270.txt,2,1,0,3
170,170-20160508-15-000171.txt,2,0,0,2
170,170-20160508-15-000182.txt,2,1,0,3
170,170-20160704-15-000083.txt,0,0,0,0
170,170-20160505-18-000061.txt,2,1,0,3
170,170-20160704-07-000061.txt,0,1,0,1
170,170-20160704-18-000182.txt,0,1,0,1
170,170-20160508-15-000080.txt,2,0,0,2
170,170-20160704-15-000266.txt,1,1,0,2
170,170-20160704-18-000085.txt,2,1,0,3
170,170-20160503-07-000106.txt,2,0,0,2
170,170-20160508-18-000072.txt,2,0,1,3
170,170-20160503-18-000167.txt,0,2,0,2
170,170-20160430-16-000192.txt,1,0,0,1
170,170-20160429-15-000185.txt,15,0,0,15
170,170-20160504-18-000167.txt,1,2,0,3
170,170-20160508-18-000248.txt,1,0,1,2
170,170-20160508-15-000158.txt,3,0,0,3
170,170-20160704-18-000169.txt,2,1,0,3
170,170-20160429-12-000046.txt,2,1,0,3
170,170-20160704-07-000150.txt,0,1,0,1
170,170-20160508-18-000171.txt,0,1,1,2
170,170-20160503-18-000008.txt,1,2,0,3
170,170-20160704-07-000117.txt,0,1,0,1
170,170-20160430-15-000141.txt,0,1,0,1
170,170-20160704-15-000055.txt,1,0,0,1
170,170-20160704-18-000176.txt,0,1,0,1
170,170-20160505-18-000067.txt,1,2,0,3
170,170-20160430-16-000171.txt,2,0,0,2
170,170-20160430-18-000067.txt,2,0,0,2
170,170-20160430-18-000006.txt,0,1,0,1
170,170-20160503-18-000280.txt,1,2,0,3
170,170-20160503-18-000246.txt,0,3,0,3
170,170-20160429-12-000078.txt,2,1,0,3
170,170-20160425-18-000259.txt,17,0,0,17
170,170-20160429-18-000202.txt,12,2,0,14
170,170-20160704-07-000138.txt,0,2,0,2
170,170-20160429-12-000049.txt,2,1,0,3
170,170-20160508-15-000166.txt,2,0,0,2
170,170-20160704-15-000176.txt,1,0,0,1
170,170-20160503-07-000209.txt,1,1,1,3
170,170-20160704-18-000091.txt,1,1,0,2
170,170-20160704-12-000184.txt,2,0,0,2
170,170-20160430-15-000068.txt,2,0,0,2
173,173-20160429-07-000041.txt,9,2,1,12
173,173-20160704-18-000294.txt,1,0,0,1
173,173-20160704-12-000110.txt,4,0,0,4
173,173-20160429-07-000021.txt,3,2,1,6
173,173-20160704-15-000129.txt,4,0,0,4
173,173-20160704-12-000293.txt,2,0,0,2
173,173-20160430-15-000137.txt,20,0,1,21
173,173-20160704-18-000020.txt,3,0,0,3
173,173-20160704-15-000165.txt,2,0,0,2
173,173-20160504-18-000267.txt,3,0,0,3
173,173-20160429-18-000204.txt,3,1,0,4
173,173-20160505-18-000294.txt,19,1,0,20
173,173-20160704-15-000145.txt,1,0,0,1
173,173-20160504-18-000158.txt,5,0,0,5
173,173-20160704-15-000248.txt,1,1,0,2
173,173-20160704-12-000060.txt,3,2,0,5
173,173-20160704-07-000221.txt,1,0,0,1
173,173-20160704-12-000046.txt,3,2,0,5
173,173-20160704-18-000225.txt,1,0,0,1
173,173-20160704-18-000182.txt,4,0,0,4
173,173-20160704-12-000047.txt,2,2,0,4
173,173-20160502-18-000179.txt,2,2,0,4
173,173-20160430-18-000081.txt,3,0,0,3
173,173-20160429-07-000030.txt,2,1,1,4
173,173-20160429-07-000014.txt,4,3,1,8
173,173-20160429-07-000050.txt,9,1,3,13
173,173-20160704-07-000204.txt,0,0,0,0
173,173-20160704-07-000073.txt,0,0,0,0
173,173-20160704-18-000023.txt,3,0,0,3
173,173-20160704-12-000076.txt,3,1,0,4
173,173-20160704-07-000193.txt,1,0,0,1
173,173-20160429-07-000029.txt,2,1,1,4
173,173-20160504-18-000112.txt,3,0,0,3
173,173-20160704-07-000187.txt,4,0,0,4
173,173-20160429-07-000019.txt,5,2,1,8
173,173-20160429-07-000007.txt,3,2,2,7
173,173-20160429-15-000185.txt,3,0,0,3
173,173-20160704-15-000202.txt,3,0,0,3
173,173-20160430-18-000293.txt,22,0,0,22
173,173-20160704-15-000173.txt,3,0,0,3
173,173-20160704-07-000093.txt,0,0,0,0
173,173-20160430-18-000291.txt,23,0,0,23
173,173-20160704-15-000172.txt,3,0,0,3
173,173-20160429-12-000102.txt,3,0,2,5
173,173-20160704-07-000109.txt,2,0,0,2
173,173-20160704-18-000292.txt,1,0,0,1
173,173-20160429-07-000028.txt,3,1,1,5
173,173-20160704-15-000257.txt,0,1,0,1
173,173-20160502-18-000270.txt,3,1,0,4
173,173-20160429-07-000016.txt,3,4,1,8
173,173-20160704-12-000211.txt,1,1,0,2
173,173-20160704-12-000005.txt,2,1,0,3
173,173-20160429-12-000182.txt,2,0,2,4
173,173-20160704-12-000203.txt,1,0,0,1
173,173-20160704-18-000087.txt,2,2,0,4
173,173-20160704-18-000248.txt,1,0,0,1
173,173-20160704-18-000192.txt,3,0,0,3
173,173-20160704-18-000223.txt,2,0,0,2
173,173-20160704-07-000166.txt,0,0,0,0
173,173-20160704-07-000224.txt,0,0,0,0
173,173-20160704-18-000240.txt,1,0,0,1
173,173-20160704-15-000052.txt,4,1,0,5
173,173-20160704-15-000131.txt,2,0,0,2
173,173-20160704-18-000234.txt,2,0,0,2
173,173-20160704-18-000272.txt,3,0,0,3
173,173-20160704-12-000139.txt,3,0,0,3
173,173-20160429-07-000035.txt,3,1,1,5
173,173-20160429-18-000112.txt,0,0,0,0
173,173-20160429-07-000027.txt,3,2,1,6
173,173-20160704-18-000096.txt,2,2,0,4
173,173-20160429-07-000020.txt,4,2,1,7
173,173-20160704-07-000217.txt,0,0,0,0
173,173-20160704-15-000278.txt,2,0,0,2
173,173-20160704-12-000280.txt,1,0,1,2
173,173-20160704-07-000003.txt,2,0,0,2
173,173-20160704-15-000166.txt,3,0,0,3
173,173-20160704-18-000032.txt,1,0,0,1
173,173-20160429-07-000033.txt,2,1,1,4
173,173-20160502-18-000157.txt,3,1,0,4
173,173-20160429-18-000250.txt,0,2,0,2
173,173-20160508-15-000238.txt,5,0,0,5
173,173-20160430-15-000034.txt,5,0,0,5
173,173-20160704-12-000001.txt,0,1,0,1
173,173-20160704-07-000123.txt,0,0,0,0
173,173-20160429-07-000009.txt,4,2,1,7
173,173-20160704-15-000144.txt,1,0,0,1
173,173-20160429-07-000046.txt,11,2,2,15
173,173-20160429-07-000015.txt,3,3,1,7
173,173-20160704-07-000292.txt,0,1,0,1
173,173-20160429-07-000010.txt,6,2,1,9
173,173-20160704-12-000038.txt,1,2,0,3
173,173-20160704-12-000208.txt,1,1,0,2
173,173-20160704-18-000019.txt,2,0,0,2
173,173-20160704-18-000052.txt,2,1,0,3
173,173-20160429-07-000026.txt,3,2,1,6
173,173-20160429-15-000161.txt,5,0,0,5
173,173-20160704-18-000227.txt,2,0,0,2
173,173-20160704-15-000024.txt,5,0,0,5
173,173-20160704-18-000193.txt,4,0,0,4
173,173-20160704-18-000166.txt,4,0,0,4
173,173-20160429-07-000008.txt,2,2,2,6
173,173-20160508-18-000007.txt,4,0,1,5
173,173-20160704-07-000118.txt,1,0,1,2
173,173-20160704-15-000210.txt,0,0,0,0
173,173-20160704-18-000270.txt,2,0,0,2
173,173-20160704-07-000153.txt,0,0,0,0
173,173-20160704-07-000115.txt,1,0,0,1
173,173-20160704-07-000042.txt,2,0,0,2
173,173-20160704-18-000044.txt,4,0,0,4
173,173-20160429-18-000245.txt,1,2,0,3
173,173-20160429-12-000111.txt,2,0,2,4
173,173-20160704-07-000119.txt,1,0,1,2
173,173-20160704-07-000158.txt,0,0,0,0
173,173-20160704-15-000294.txt,0,0,0,0
173,173-20160429-07-000047.txt,10,2,2,14
173,173-20160704-07-000210.txt,0,0,0,0
173,173-20160704-07-000088.txt,0,0,0,0
173,173-20160429-07-000017.txt,3,3,1,7
173,173-20160704-07-000078.txt,0,0,0,0
173,173-20160704-12-000059.txt,3,2,0,5
173,173-20160704-15-000141.txt,1,0,0,1
173,173-20160429-15-000108.txt,5,0,0,5
173,173-20160430-18-000007.txt,2,0,0,2
173,173-20160502-18-000271.txt,3,1,0,4
173,173-20160508-18-000013.txt,3,0,1,4
173,173-20160429-07-000038.txt,5,2,1,8
173,173-20160704-15-000039.txt,5,0,0,5
173,173-20160704-18-000257.txt,1,0,0,1
173,173-20160429-18-000256.txt,2,2,1,5
173,173-20160704-18-000160.txt,3,1,0,4
173,173-20160429-07-000045.txt,11,1,2,14
173,173-20160704-12-000145.txt,3,0,0,3
173,173-20160429-07-000036.txt,3,2,1,6
173,173-20160429-12-000104.txt,2,0,2,4
173,173-20160704-07-000223.txt,0,0,0,0
173,173-20160429-07-000003.txt,3,1,1,5
173,173-20160502-18-000120.txt,5,0,0,5
173,173-20160704-12-000051.txt,2,2,0,4
173,173-20160429-07-000025.txt,3,2,1,6
173,173-20160430-15-000138.txt,19,1,1,21
173,173-20160704-12-000174.txt,5,0,0,5
173,173-20160704-07-000191.txt,1,0,0,1
173,173-20160429-07-000031.txt,2,1,1,4
173,173-20160429-07-000023.txt,4,1,1,6
173,173-20160704-18-000290.txt,1,0,0,1
173,173-20160704-07-000059.txt,0,1,0,1
173,173-20160429-07-000048.txt,10,2,2,14
173,173-20160704-18-000039.txt,5,0,0,5
173,173-20160704-07-000013.txt,0,0,0,0
173,173-20160502-18-000274.txt,3,1,0,4
173,173-20160704-15-000074.txt,2,1,0,3
173,173-20160704-18-000123.txt,1,1,0,2
173,173-20160704-15-000220.txt,0,1,0,1
173,173-20160704-07-000084.txt,0,0,0,0
173,173-20160704-15-000099.txt,4,0,0,4
173,173-20160504-18-000235.txt,3,0,0,3
173,173-20160704-18-000138.txt,2,1,0,3
173,173-20160429-07-000001.txt,4,1,1,6
173,173-20160429-07-000006.txt,3,1,1,5
173,173-20160429-07-000018.txt,5,2,1,8
173,173-20160704-15-000230.txt,1,1,0,2
173,173-20160429-18-000087.txt,1,0,0,1
173,173-20160704-07-000279.txt,0,1,0,1
173,173-20160429-07-000034.txt,3,1,1,5
173,173-20160704-15-000030.txt,5,0,0,5
173,173-20160430-18-000113.txt,3,1,0,4
173,173-20160429-18-000238.txt,3,2,0,5
173,173-20160704-07-000281.txt,0,1,0,1
173,173-20160704-15-000224.txt,0,1,0,1
173,173-20160430-18-000012.txt,3,0,0,3
173,173-20160502-18-000242.txt,4,1,0,5
173,173-20160704-07-000256.txt,0,1,0,1
173,173-20160704-12-000265.txt,3,1,0,4
173,173-20160429-07-000040.txt,8,2,1,11
173,173-20160704-18-000222.txt,2,0,0,2
173,173-20160704-18-000177.txt,4,1,0,5
173,173-20160429-18-000084.txt,0,0,0,0
173,173-20160704-07-000229.txt,0,0,0,0
173,173-20160502-18-000170.txt,2,1,1,4
173,173-20160429-07-000037.txt,5,2,1,8
173,173-20160504-18-000252.txt,3,2,0,5
173,173-20160429-18-000244.txt,1,3,0,4
173,173-20160704-07-000095.txt,0,0,0,0
173,173-20160429-18-000264.txt,1,1,0,2
173,173-20160704-18-000265.txt,4,0,0,4
173,173-20160429-07-000042.txt,11,2,2,15
173,173-20160429-07-000004.txt,2,1,1,4
173,173-20160704-15-000063.txt,2,1,0,3
173,173-20160430-18-000037.txt,3,0,0,3
173,173-20160429-07-000032.txt,2,1,1,4
173,173-20160429-07-000022.txt,3,2,1,6
173,173-20160429-18-000093.txt,0,1,0,1
173,173-20160704-07-000126.txt,0,1,0,1
173,173-20160704-15-000150.txt,3,0,0,3
173,173-20160704-07-000138.txt,0,0,0,0
173,173-20160430-18-000011.txt,3,0,0,3
173,173-20160704-15-000107.txt,4,0,0,4
173,173-20160504-18-000293.txt,18,1,1,20
173,173-20160704-07-000127.txt,0,0,0,0
173,173-20160704-07-000146.txt,0,0,0,0
398,398-20160429-07-000073.txt,12,0,9,21
398,398-20160429-07-000043.txt,11,1,8,20
398,398-20160429-07-000016.txt,9,0,6,15
398,398-20160429-07-000044.txt,11,0,8,19
398,398-20160429-07-000132.txt,11,0,6,17
398,398-20160429-07-000067.txt,13,0,9,22
398,398-20160704-12-000002.txt,8,0,0,8
398,398-20160429-07-000002.txt,9,1,6,16
398,398-20160429-07-000061.txt,12,0,9,21
398,398-20160429-07-000092.txt,2,2,5,9
398,398-20160429-07-000066.txt,13,0,9,22
398,398-20160429-12-000028.txt,17,0,3,20
398,398-20160430-12-000130.txt,2,0,0,2
398,398-20160429-07-000144.txt,13,0,6,19
398,398-20160430-12-000227.txt,4,0,0,4
398,398-20160429-07-000141.txt,13,0,6,19
398,398-20160430-12-000285.txt,4,0,0,4
398,398-20160429-07-000137.txt,12,0,6,18
398,398-20160429-07-000079.txt,12,0,9,21
398,398-20160429-07-000133.txt,12,0,6,18
398,398-20160429-07-000112.txt,11,0,6,17
398,398-20160503-07-000194.txt,7,0,0,7
398,398-20160429-07-000128.txt,12,0,6,18
398,398-20160429-07-000019.txt,6,0,7,13
398,398-20160704-12-000138.txt,7,0,0,7
398,398-20160704-12-000296.txt,6,0,0,6
398,398-20160429-12-000037.txt,17,0,4,21
398,398-20160429-12-000014.txt,18,0,2,20
398,398-20160429-07-000063.txt,11,0,9,20
398,398-20160429-07-000031.txt,11,0,6,17
398,398-20160429-07-000106.txt,16,0,5,21
398,398-20160429-07-000053.txt,12,0,8,20
398,398-20160429-07-000004.txt,12,1,8,21
398,398-20160429-12-000042.txt,17,2,4,23
398,398-20160704-12-000058.txt,6,0,0,6
398,398-20160429-07-000049.txt,12,0,8,20
398,398-20160429-12-000032.txt,17,0,3,20
398,398-20160429-07-000070.txt,13,0,9,22
398,398-20160429-07-000022.txt,8,0,6,14
398,398-20160429-07-000119.txt,12,0,6,18
398,398-20160429-07-000051.txt,11,0,8,19
398,398-20160429-12-000012.txt,17,0,3,20
398,398-20160429-07-000142.txt,13,0,6,19
398,398-20160429-07-000075.txt,12,0,9,21
398,398-20160429-07-000087.txt,0,1,7,8
398,398-20160429-07-000040.txt,10,1,8,19
398,398-20160429-07-000006.txt,14,0,5,19
398,398-20160430-12-000121.txt,1,0,0,1
398,398-20160429-07-000005.txt,12,1,7,20
398,398-20160429-07-000028.txt,11,0,5,16
398,398-20160429-07-000060.txt,11,0,9,20
398,398-20160429-07-000138.txt,12,0,6,18
398,398-20160429-07-000048.txt,12,0,8,20
398,398-20160429-07-000118.txt,11,0,6,17
398,398-20160429-12-000044.txt,17,0,2,19
398,398-20160430-12-000216.txt,4,0,0,4
398,398-20160429-07-000103.txt,17,0,5,22
398,398-20160429-07-000072.txt,12,0,9,21
398,398-20160429-07-000125.txt,11,0,6,17
398,398-20160704-15-000139.txt,8,0,0,8
398,398-20160429-07-000115.txt,11,0,6,17
398,398-20160429-12-000018.txt,16,0,3,19
398,398-20160430-12-000038.txt,6,0,0,6
398,398-20160429-07-000129.txt,11,0,6,17
398,398-20160430-12-000195.txt,5,1,0,6
398,398-big_bus-mask1-000031.txt,5,1,1,7
398,398-20160430-12-000043.txt,5,0,0,5
398,398-20160429-12-000016.txt,18,0,3,21
398,398-20160429-12-000029.txt,16,0,2,18
398,398-20160429-12-000008.txt,15,0,4,19
398,398-20160503-07-000034.txt,7,0,1,8
398,398-20160429-12-000015.txt,18,0,2,20
398,398-20160429-07-000086.txt,3,1,7,11
398,398-20160429-12-000013.txt,19,0,3,22
398,398-20160508-15-000150.txt,7,1,0,8
398,398-20160429-12-000009.txt,15,0,3,18
398,398-20160429-07-000076.txt,12,0,9,21
398,398-20160429-07-000064.txt,12,0,9,21
398,398-20160429-07-000123.txt,11,0,6,17
398,398-20160429-07-000025.txt,14,0,5,19
398,398-20160429-07-000054.txt,12,0,8,20
398,398-20160429-12-000017.txt,16,0,3,19
398,398-20160430-12-000131.txt,3,0,0,3
398,398-20160429-07-000120.txt,12,0,6,18
398,398-20160429-07-000038.txt,10,1,8,19
398,398-20160429-12-000030.txt,16,0,3,19
398,398-20160429-07-000029.txt,11,0,5,16
398,398-20160429-07-000095.txt,8,1,4,13
398,398-20160429-07-000045.txt,11,0,8,19
398,398-20160429-07-000058.txt,13,0,8,21
398,398-20160429-07-000107.txt,15,0,5,20
398,398-20160429-12-000007.txt,14,0,4,18
398,398-20160429-07-000015.txt,11,0,6,17
398,398-20160429-07-000023.txt,8,0,7,15
398,398-20160429-07-000100.txt,13,0,4,17
398,398-20160429-07-000030.txt,11,0,5,16
398,398-20160429-07-000116.txt,11,0,6,17
398,398-20160429-12-000026.txt,15,0,2,17
398,398-20160429-07-000098.txt,14,0,4,18
398,398-20160429-12-000036.txt,17,0,2,19
398,398-20160430-12-000279.txt,7,1,0,8
398,398-20160508-15-000152.txt,5,1,0,6
398,398-20160429-07-000139.txt,12,0,6,18
398,398-20160429-12-000034.txt,17,0,3,20
398,398-20160429-07-000094.txt,5,2,5,12
398,398-20160429-12-000038.txt,17,0,4,21
398,398-20160430-12-000041.txt,5,0,0,5
398,398-20160429-07-000130.txt,11,0,6,17
398,398-20160503-07-000279.txt,6,1,0,7
398,398-20160430-12-000150.txt,8,0,0,8
398,398-20160429-07-000146.txt,12,0,6,18
398,398-20160429-12-000039.txt,18,1,4,23
398,398-20160429-07-000059.txt,12,0,8,20
398,398-20160429-07-000096.txt,9,1,4,14
398,398-20160429-07-000089.txt,0,2,5,7
398,398-20160429-07-000039.txt,11,1,8,20
398,398-20160429-12-000020.txt,17,0,2,19
398,398-20160429-07-000101.txt,14,0,5,19
398,398-20160429-07-000134.txt,11,0,6,17
398,398-20160429-12-000045.txt,18,0,4,22
398,398-20160429-07-000036.txt,10,0,8,18
398,398-20160429-12-000003.txt,18,1,2,21
398,398-20160429-07-000001.txt,9,1,7,17
398,398-20160508-15-000091.txt,7,0,0,7
398,398-20160429-07-000033.txt,10,0,7,17
398,398-20160429-07-000003.txt,9,1,6,16
398,398-20160429-07-000082.txt,9,0,9,18
398,398-20160429-12-000040.txt,17,1,4,22
398,398-20160429-07-000062.txt,11,0,9,20
398,398-20160429-07-000091.txt,1,2,4,7
398,398-20160429-07-000136.txt,11,0,6,17
398,398-20160429-07-000127.txt,12,0,6,18
398,398-20160429-12-000031.txt,17,0,3,20
398,398-20160429-07-000041.txt,10,1,8,19
398,398-20160429-12-000043.txt,17,0,4,21
398,398-20160429-07-000147.txt,12,0,6,18
398,398-20160429-07-000020.txt,9,0,8,17
398,398-20160429-07-000032.txt,10,0,7,17
398,398-20160429-07-000148.txt,12,0,6,18
398,398-20160429-07-000081.txt,10,0,8,18
398,398-20160429-12-000041.txt,17,1,4,22
398,398-20160429-07-000143.txt,12,0,6,18
398,398-20160430-12-000218.txt,3,0,0,3
398,398-20160429-07-000131.txt,11,0,6,17
398,398-20160430-18-000286.txt,8,0,0,8
398,398-20160429-07-000140.txt,13,0,6,19
398,398-20160429-07-000084.txt,8,0,6,14
398,398-20160429-07-000057.txt,12,0,8,20
398,398-20160429-07-000009.txt,14,0,5,19
398,398-20160704-15-000284.txt,7,0,0,7
398,398-20160429-07-000085.txt,6,0,6,12
398,398-20160508-15-000154.txt,6,0,0,6
398,398-20160429-07-000078.txt,12,0,9,21
398,398-20160704-12-000297.txt,6,0,0,6
398,398-20160429-07-000077.txt,12,0,9,21
398,398-20160429-07-000108.txt,13,0,4,17
398,398-20160704-12-000066.txt,7,1,0,8
398,398-20160429-07-000113.txt,11,0,6,17
398,398-20160429-12-000001.txt,18,1,1,20
398,398-20160429-07-000047.txt,12,0,8,20
398,398-20160429-07-000110.txt,11,0,4,15
398,398-20160429-07-000104.txt,16,0,5,21
398,398-20160429-07-000021.txt,9,0,6,15
398,398-20160429-07-000012.txt,10,0,7,17
398,398-20160508-18-000034.txt,7,0,0,7
398,398-20160429-07-000008.txt,14,0,5,19
398,398-20160429-07-000065.txt,12,0,9,21
398,398-20160429-12-000021.txt,21,0,2,23
398,398-20160429-07-000093.txt,2,2,5,9
398,398-20160429-07-000027.txt,13,0,4,17
398,398-20160429-07-000026.txt,13,0,5,18
398,398-20160429-07-000056.txt,12,0,8,20
398,398-20160429-12-000035.txt,17,0,3,20
398,398-20160429-07-000126.txt,11,0,6,17
398,398-20160430-12-000196.txt,3,1,0,4
398,398-20160430-12-000241.txt,7,0,0,7
398,398-20160429-07-000071.txt,12,0,9,21
398,398-20160429-12-000022.txt,20,0,2,22
398,398-20160704-12-000292.txt,6,0,0,6
398,398-20160704-12-000127.txt,7,1,0,8
398,398-20160429-12-000019.txt,19,0,3,22
398,398-20160429-07-000099.txt,13,0,4,17
398,398-20160430-12-000381.txt,7,0,0,7
398,398-20160508-15-000093.txt,7,0,0,7
398,398-20160503-07-000040.txt,7,0,1,8
398,398-20160429-07-000114.txt,11,0,6,17
398,398-20160429-07-000010.txt,13,0,4,17
398,398-20160429-07-000102.txt,14,0,5,19
398,398-20160429-12-000027.txt,15,0,1,16
398,398-20160429-07-000122.txt,11,0,6,17
398,398-20160429-07-000024.txt,9,0,5,14
398,398-20160429-07-000088.txt,0,2,7,9
398,398-20160429-07-000111.txt,12,0,6,18
398,398-20160429-07-000069.txt,13,0,9,22
398,398-20160429-07-000055.txt,12,0,8,20
398,398-20160508-15-000080.txt,8,0,0,8
398,398-20160429-07-000080.txt,13,0,8,21
398,398-20160429-12-000033.txt,17,0,3,20
398,398-20160429-07-000046.txt,11,0,8,19
398,398-20160429-07-000149.txt,12,0,6,18
410,410-20160430-12-000071.txt,0,0,0,0
410,410-20160503-07-000400.txt,5,0,2,7
410,410-20160430-15-000151.txt,4,0,1,5
410,410-20160429-07-000139.txt,5,0,4,9
410,410-20160503-07-000354.txt,5,0,3,8
410,410-20160503-07-000072.txt,4,0,2,6
410,410-20160508-18-000028.txt,10,0,0,10
410,410-20160503-07-000183.txt,6,0,4,10
410,410-20160704-12-000267.txt,7,1,0,8
410,410-20160430-12-000184.txt,0,0,0,0
410,410-20160704-12-000283.txt,9,1,0,10
410,410-20160704-12-000242.txt,9,0,0,9
410,410-20160430-18-000080.txt,4,0,0,4
410,410-20160704-12-000006.txt,9,1,0,10
410,410-20160430-18-000077.txt,4,0,0,4
410,410-20160704-18-000058.txt,10,0,0,10
410,410-20160503-07-000243.txt,2,0,3,5
410,410-20160704-12-000249.txt,9,0,1,10
410,410-20160429-07-000270.txt,2,0,2,4
410,410-20160503-07-000048.txt,5,1,3,9
410,410-20160430-15-000133.txt,9,0,0,9
410,410-20160430-12-000180.txt,0,0,0,0
410,410-20160704-07-000179.txt,11,0,0,11
410,410-20160503-07-000162.txt,5,0,3,8
410,410-20160503-07-000077.txt,1,0,2,3
410,410-20160704-18-000210.txt,8,0,0,8
410,410-20160508-18-000147.txt,8,0,0,8
410,410-20160430-12-000032.txt,0,0,0,0
410,410-20160503-07-000071.txt,5,0,2,7
410,410-20160430-12-000011.txt,0,0,0,0
410,410-20160430-18-000022.txt,7,0,1,8
410,410-20160429-18-000245.txt,6,0,0,6
410,410-20160508-18-000094.txt,7,0,0,7
410,410-20160704-12-000167.txt,10,0,0,10
410,410-20160430-12-000055.txt,0,0,0,0
410,410-20160430-18-000111.txt,6,0,0,6
410,410-20160704-18-000206.txt,8,0,0,8
410,410-20160504-18-000037.txt,29,2,1,32
410,410-20160429-07-000271.txt,2,0,2,4
410,410-20160430-15-000258.txt,5,0,0,5
410,410-20160503-07-000084.txt,1,0,3,4
410,410-20160430-15-000086.txt,8,0,0,8
410,410-20160430-12-000038.txt,0,0,0,0
410,410-20160503-07-000113.txt,1,0,3,4
410,410-20160430-12-000046.txt,0,0,0,0
410,410-20160429-07-000189.txt,6,1,2,9
410,410-20160429-07-000276.txt,2,0,2,4
410,410-20160704-15-000097.txt,11,0,0,11
410,410-20160508-18-000264.txt,10,0,0,10
410,410-20160429-07-000303.txt,7,0,1,8
410,410-20160430-12-000049.txt,0,0,0,0
410,410-20160503-07-000038.txt,3,0,2,5
410,410-20160503-07-000021.txt,2,0,2,4
410,410-20160430-12-000118.txt,0,0,0,0
410,410-20160430-18-000110.txt,5,0,0,5
410,410-20160503-07-000020.txt,2,0,2,4
410,410-20160430-18-000037.txt,9,0,1,10
410,410-20160430-15-000091.txt,8,0,0,8
410,410-20160503-07-000417.txt,7,0,3,10
410,410-20160430-15-000288.txt,6,1,1,8
410,410-20160429-18-000237.txt,5,0,0,5
410,410-20160430-15-000012.txt,6,0,1,7
410,410-20160429-07-000092.txt,7,0,2,9
410,410-20160704-12-000295.txt,9,1,0,10
410,410-20160704-12-000194.txt,8,0,0,8
410,410-20160429-18-000044.txt,7,0,2,9
410,410-20160430-15-000213.txt,9,0,0,9
410,410-20160508-18-000070.txt,2,1,0,3
410,410-20160508-18-000136.txt,6,0,0,6
410,410-20160430-15-000134.txt,7,0,0,7
410,410-20160704-12-000294.txt,9,1,0,10
410,410-20160503-07-000156.txt,3,0,3,6
410,410-20160429-18-000232.txt,3,0,0,3
410,410-20160704-12-000251.txt,8,1,1,10
410,410-20160430-12-000186.txt,0,0,0,0
410,410-20160429-18-000240.txt,5,0,0,5
410,410-20160508-18-000193.txt,9,0,0,9
410,410-20160704-12-000051.txt,9,1,0,10
410,410-20160508-18-000138.txt,9,0,0,9
410,410-20160704-12-000169.txt,9,0,0,9
410,410-20160429-18-000254.txt,6,0,0,6
410,410-20160704-12-000257.txt,5,1,0,6
410,410-20160704-12-000029.txt,8,1,0,9
410,410-20160429-07-000321.txt,5,0,2,7
410,410-20160704-18-000152.txt,35,0,0,35
410,410-20160508-18-000188.txt,9,0,0,9
410,410-20160503-07-000114.txt,1,0,3,4
410,410-20160508-18-000176.txt,8,0,0,8
410,410-20160430-18-000102.txt,4,0,0,4
410,410-20160430-18-000085.txt,4,0,0,4
410,410-20160430-15-000284.txt,9,0,1,10
410,410-20160429-07-000107.txt,7,0,2,9
410,410-20160429-07-000328.txt,5,0,2,7
410,410-20160430-18-000021.txt,7,0,1,8
410,410-20160508-18-000031.txt,10,0,0,10
410,410-20160430-12-000091.txt,0,0,0,0
410,410-20160503-07-000259.txt,4,0,3,7
410,410-20160430-15-000235.txt,2,0,0,2
410,410-20160430-15-000180.txt,4,0,1,5
410,410-20160429-07-000268.txt,2,0,2,4
410,410-20160503-07-000129.txt,6,0,4,10
410,410-20160429-07-000246.txt,2,0,2,4
410,410-20160430-15-000239.txt,3,0,0,3
410,410-20160430-15-000038.txt,7,0,2,9
410,410-big_bus-000067.txt,9,0,2,11
410,410-20160508-18-000227.txt,10,0,0,10
410,410-20160430-12-000095.txt,0,0,0,0
410,410-20160503-07-000478.txt,4,0,3,7
410,410-20160704-18-000149.txt,35,0,0,35
410,410-20160704-18-000052.txt,9,0,0,9
410,410-20160508-18-000245.txt,9,0,0,9
410,410-20160503-07-000097.txt,1,0,3,4
410,410-20160430-15-000182.txt,5,0,1,6
410,410-20160503-07-000191.txt,7,0,4,11
410,410-20160430-15-000005.txt,5,0,1,6
410,410-20160503-07-000081.txt,1,0,3,4
410,410-20160429-07-000334.txt,7,0,2,9
410,410-20160430-12-000135.txt,0,0,0,0
410,410-20160430-18-000190.txt,7,1,1,9
410,410-20160704-12-000285.txt,9,1,0,10
410,410-20160508-18-000076.txt,5,0,0,5
410,410-20160704-15-000237.txt,10,0,0,10
410,410-20160430-12-000075.txt,0,0,0,0
410,410-20160503-07-000232.txt,3,0,3,6
410,410-20160503-07-000067.txt,6,0,4,10
410,410-20160503-07-000262.txt,4,0,3,7
410,410-20160430-12-000061.txt,0,0,0,0
410,410-20160430-15-000078.txt,8,0,0,8
410,410-20160508-18-000146.txt,9,0,0,9
410,410-20160503-07-000265.txt,4,0,3,7
410,410-20160430-18-000149.txt,6,1,1,8
410,410-20160503-07-000274.txt,4,0,3,7
410,410-20160704-18-000141.txt,34,0,0,34
410,410-20160430-15-000061.txt,7,0,0,7
410,410-20160430-12-000013.txt,0,0,0,0
410,410-20160429-07-000317.txt,5,0,2,7
410,410-20160430-15-000248.txt,4,0,0,4
410,410-20160503-07-000350.txt,5,0,3,8
410,410-20160508-18-000091.txt,7,0,0,7
410,410-20160430-12-000030.txt,0,0,0,0
410,410-20160430-18-000097.txt,4,0,0,4
410,410-20160430-12-000004.txt,0,0,0,0
410,410-20160429-07-000090.txt,7,0,2,9
410,410-20160503-07-000168.txt,5,0,3,8
410,410-20160430-15-000032.txt,8,0,1,9
410,410-20160503-07-000096.txt,1,0,3,4
410,410-20160429-07-000322.txt,5,0,2,7
410,410-20160503-07-000302.txt,6,0,4,10
410,410-20160503-07-000144.txt,5,0,4,9
410,410-20160429-07-000314.txt,5,0,2,7
410,410-20160503-07-000416.txt,7,0,3,10
410,410-20160430-12-000001.txt,0,0,0,0
410,410-20160503-07-000176.txt,5,0,4,9
410,410-20160503-07-000499.txt,4,0,3,7
410,410-20160704-15-000043.txt,10,0,0,10
410,410-20160508-18-000129.txt,8,1,0,9
410,410-20160508-18-000032.txt,10,0,0,10
410,410-20160430-12-000151.txt,0,0,0,0
410,410-20160430-15-000252.txt,4,0,0,4
410,410-20160430-15-000160.txt,4,0,1,5
410,410-20160508-18-000086.txt,7,0,0,7
410,410-20160430-15-000145.txt,3,0,1,4
410,410-20160503-07-000490.txt,4,0,3,7
410,410-20160704-18-000136.txt,33,0,0,33
410,410-20160503-07-000150.txt,4,0,4,8
410,410-20160503-07-000383.txt,6,0,3,9
410,410-20160503-07-000464.txt,4,1,5,10
410,410-20160430-12-000168.txt,0,0,0,0
410,410-20160503-07-000237.txt,2,0,3,5
410,410-20160430-18-000113.txt,6,0,0,6
410,410-20160430-12-000143.txt,0,0,0,0
410,410-20160503-07-000069.txt,7,0,2,9
410,410-20160704-12-000179.txt,8,0,0,8
410,410-20160704-12-000186.txt,8,0,0,8
410,410-20160503-07-000134.txt,6,0,3,9
410,410-20160704-12-000098.txt,10,0,0,10
410,410-20160704-12-000083.txt,11,0,0,11
410,410-20160704-15-000046.txt,10,0,0,10
410,410-20160704-12-000217.txt,9,0,0,9
410,410-20160430-12-000124.txt,0,0,0,0
410,410-20160704-12-000236.txt,10,0,0,10
410,410-20160704-12-000036.txt,8,1,0,9
410,410-20160503-07-000484.txt,4,0,3,7
410,410-20160704-07-000169.txt,11,0,0,11
410,410-20160429-07-000247.txt,2,0,2,4
410,410-20160508-18-000093.txt,7,0,0,7
410,410-20160508-18-000131.txt,7,1,0,8
410,410-20160704-12-000293.txt,9,1,0,10
410,410-20160704-15-000027.txt,10,0,0,10
410,410-20160704-18-000143.txt,34,0,0,34
410,410-20160503-07-000398.txt,5,0,2,7
410,410-20160430-18-000060.txt,8,1,1,10
410,410-20160430-15-000075.txt,8,0,0,8
410,410-20160704-12-000032.txt,8,1,0,9
410,410-20160503-07-000491.txt,4,0,3,7
410,410-20160704-12-000112.txt,10,0,0,10
410,410-20160508-18-000132.txt,9,1,0,10
410,410-20160503-07-000092.txt,1,0,3,4
410,410-20160503-07-000068.txt,7,0,3,10
410,410-20160429-07-000067.txt,7,0,3,10
